"1","1","1","2","2","3","3","3","3"
"1","1","2","2","2","3","3","3","3"
"1","1","2","2","5","4","4","4","3"
"1","1","2","2","5","4","4","4","4"
"6","6","5","5","5","5","5","4","4"
"6","6","6","6","5","8","8","9","9"
"7","6","6","6","5","8","8","9","9"
"7","7","7","7","8","8","8","9","9"
"7","7","7","7","8","8","9","9","9"
"
"
"0","1","9","7","8","2","6","4","5"
"0","2","4","9","6","8","7","1","3"
"0","8","5","2","3","4","1","6","9"
"0","0","1","3","7","9","5","2","8"
"9","4","6","8","5","1","2","3","7"
"1","7","8","6","9","3","4","5","2"
"8","3","2","5","4","6","9","7","1"
"2","5","3","4","1","7","8","9","6"
"6","9","7","1","2","5","3","8","4"
